0
0
WWWWWW
WEEEEW
WEPEEW
WEEBEW
WEETEW
WWWWWW
