0
31
WWWWWWWW
WWWE1EWW
WTPBEEWW
WWWEBTWW
WTWWBEWW
WEWETEWW
WBEBBBTW
W1EETEEW
WWWWWWWW
