0
WWWWWWWWWWWW
WEETEEEEEEEW
WEEBEEEPBETW
WEEEEEEEEEEW
WTEEBEEEEEEW
WWWWWWWWWWWW