0
WWWWWWWW
WWWE1EWW
WTPBEEWW
WWWEBEWW
WEWWBEWW
WEWEEEWW
WBEBBBEW
W1EEEEEW
WWWWWWWW