00000000
00011100
04231100
00013100
01003100
01011100
03133310
01111110
00000000