WWWWWW
WEEEEW
WEPEEW
WEEEEW
WEEEEW
WWWWWW