000000000000
011411111110
011311123140
011111111110
041131111110
000000000000