0
0
EEEEEEEEWWWWWWWWE
EEEEEEEEWEEEEEPWE
EEEEEEEEWEBWBEWWE
EEEEEEEEWWBEEBWEE
EEEEEEEEWEBEBEWEE
WWWWWWWWWEBEWEWWW
WTTTTEEWWEBEEBEEW
WWTTTEEEEBEEBEEEW
WTTTTEEWWWWWWWWWW
WWWWWWWWWWWWWWWWW