WWWWWWWWWWWWWWWWWWWWWW
WWWWWWWWWWWWWWWEETTTTW
WWWWWWWWWWWWWWWEETTTTW
WWEEWEEEEWEEBEBEWPETTW
WWWWWWWWWWWWWWWEETTTTW
WWWWWWWWWWWWWWWEETTTTW
WWWWWWWWWWWWWWWWWWWWWW
WWWWWWWWWWWWWWWWWWWWWW
WWWWWWWWWWWWWWWWWWWWWW
WWWWWWWWWWWWWWWWWWWWWW
WWWWWWWWWWWWWWWWWWWWWW
WWWWWWWWWWWWWWWWWWWWWW
WWWWWWWWWWWWWWWWWWWWWW