WWWWWWWWWWWWWW
WTTEEWEEEEEWWW
WTTEEWEBEEBEEW
WTTEEWBWWWWEEW
WTTEEEEPEWWEEW
WTTEEWEWEEBEWW
WWWWWWEWWBEBEW
WWWEBEEBEBEBEW
WWWEEEEWEEEEEW
WWWWWWWWWWWWWW