0
WWWWWWWW
WWWEEEWW
WTPBEEWW
WWWEBEWW
WEWWBEWW
WEWEEEWW
WBEBBBEW
WEEEEEEW
WWWWWWWW