15
12
WWWWWWWWWWWW
WEETEEEEEE1W
WEEBEEEPBETW
WEEEEEEEEEEW
WTEEBEE1EEEW
WWWWWWWWWWWW
